111111111111111111111
1P0000000000000000001
1000000000000E000001
10C000000000000000001
111111111111111111111
