11111111111
10000100001
1P000E000C1
10000100001
11111111111
11111111111
11111111111
