1111111111111111111111111111
1C00000000100000000000000001
1000000000100000000000000001
1000000000E0CCCCC00000000001
10000000001000000000000010P1
1111111111111111111111111111
