1111111111111
10000000001P1
1010110000001
1E10000011111
1111000000C11
1111111111111
