1111111111111
1C000000001P1
1010110000001
1E10000011111
111C000000C11
1111111111111
