111111111111111111111111111
1C000000000P000000000000001
100000000000000000000000001
1E0000000000000000000000001
100000000000000000000000001
100000C00000000000000000001
100000000000000000000000001
100000000000000000000000001
111111111111111111111111111
